0000000010001111
0000000010000000
0000000010000000
0000000010000000
0001111000001000
0000000000001000
0000000000001000
0000000000001000
