0000000111100100
0000000000000100
0000001111000100
0000001000000100
0001111001000000
0000001001000000
0000000001000000
0000000001000000
